WE          textures/Wallpaper2.xpm
NO          textures/Wallpaper2.xpm
SO          textures/Wallpaper2.xpm
EA          textures/Wallpaper2.xpm
C           250,250,138
F           250,250,138

1111111111111111111111111111111111111111111
1000000000000000000000000000000000000000001
1001000100010001000100010001000100010001001
1011101110111011101110111011101110111011101
1001000100010001000100010001000100010001001
1000000000000000000000000000000000000000001
1001000100010001000100010001000100010001001
1011101110111011101110111011101110111011101
1001000100010001000100010001000100010001001
1000000000000000000000000000000000000000001
1001000100010001000100010001000100010001001
1011101110111011101110111011101110111011101
1001000100010001000100010001000100010001001
1000000000000000000000000000000000000000001
1001000100010001000100010001000100010001001
1011101110111011101110111011101110111011101
1001000100010001000100010001000100010001001
100000000000000000000S000000000000000000001
1001000100010001000100010001000100010001001
1011101110111011101110111011101110111011101
1001000100010001000100010001000100010001001
1000000000000000000000000000000000000000001
1001000100010001000100010001000100010001001
1011101110111011101110111011101110111011101
1001000100010001000100010001000100010001001
1000000000000000000000000000000000000000001
1001000100010001000100010001000100010001001
1011101110111011101110111011101110111011101
1001000100010001000100010001000100010001001
1000000000000000000000000000000000000000001
1001000100010001000100010001000100010001001
1011101110111011101110111011101110111011101
1001000100010001000100010001000100010001001
1000000000000000000000000000000000000000001
1001000100010001000100010001000100010001001
1011101110111011101110111011101110111011101
1001000100010001000100010001000100010001001
1111111111111111111111111111111111111111111