                  WE          textures/netherrack.xpm
NO             textures/mossy_cobblestone.xpm
SO                       textures/cobblestone.xpm
F 122,93,200
C 99,98,0
EA            textures/cobbled_deepslate.xpm

11111111111111111111111111111111111111111111
1S000000000000000000000000000000000000000001
10000000000000000000000000000000000000000001
11111111111111111111111111111111111111111111