WE          textures/netherrack.xpm
NO    textures/mossy_cobblestone.xpm
SO                       textures/cobblestone.xpm
EA            textures/cobbled_deepslate.xpm         
F 222,100,0,

11111111111111
10000000001101
1S110000011101
10010000000001
11111111101101
10000000001101
11111111111111
