                  WE          textures/netherrack.xpm
NO             textures/mossy_cobblestone.xpm
SO                       textures/cobblestone.xpm
F 122,93,200
C 99,98,0
EA            textures/cobbled_deepslate.xpm


        1111111111111111111111111
        1000000000110000000000001
        1011000001110000000000001
        1001000000000000000000001
111111111011000001110000000000001
100000000011000001110111111111111
11110111111111011100000010001
11110111111111011101010010001
11000000110101011100000010001
10000000000000001100000010001
10000000000000001101010010001
11000001110101011111011110001 
10000001 10000011000000000N001
11111111 1111111 111111111111 