NO             textures/mossy_cobblestone.xpm
F 12,90,200
C 120,120,120
SO                       textures/cobblestone.xpm
                  WE          textures/netherrack.xpm
EA            textures/cobbled_deepslate.xpm

11111
10001
1S001
10001
11111