111111111
1S1000001
101000011
10100001
10000001
10000101
10000001
11111111
